{
	"rooms": [
		[
			["V_", "V_", "V_", "A_", "A_", "A_", "V_", "V_", "V_"],
			["V_", "W_", "W_", "W_", "DN", "W_", "W_", "W_", "V_"],
			["V_", "W_", "G_", "G_", "G_", "G_", "G_", "W_", "V_"],
			["V_", "W_", "G_", "G_", "G_", "G_", "G_", "W_", "V_"],
			["V_", "W_", "G_", "G_", "EN", "G_", "G_", "W_", "V_"],
			["V_", "W_", "G_", "G_", "G_", "G_", "G_", "W_", "V_"],
			["V_", "W_", "G_", "G_", "G_", "G_", "G_", "W_", "V_"],
			["V_", "W_", "W_", "W_", "W_", "W_", "W_", "W_", "V_"],
			["V_", "V_", "V_", "V_", "V_", "V_", "V_", "V_", "V_"]
		]
	]
}
