{
	"rooms": [
		[
			["V_", "V_", "V_", "V_", "V_", "V_", "V_", "V_", "V_", "V_", "V_", "V_", "V_", "V_", "V_", "V_", "V_", "V_"],
			["V_", "W_", "W_", "W_", "W_", "W_", "W_", "W_", "W_", "W_", "W_", "W_", "W_", "W_", "V_", "V_", "V_", "V_"],
			["V_", "W_", "G_", "G_", "G_", "G_", "G_", "G_", "G_", "G_", "G_", "G_", "G_", "W_", "V_", "V_", "V_", "V_"],
			["V_", "W_", "G_", "I_", "G_", "I_", "G_", "I_", "G_", "I_", "G_", "I_", "G_", "W_", "V_", "V_", "V_", "V_"],
			["V_", "W_", "G_", "G_", "G_", "G_", "G_", "G_", "G_", "G_", "G_", "G_", "G_", "W_", "V_", "V_", "V_", "V_"],
			["V_", "W_", "G_", "G_", "G_", "G_", "G_", "G_", "G_", "G_", "G_", "G_", "G_", "W_", "W_", "W_", "W_", "V_"],
			["V_", "W_", "G_", "G_", "G_", "G_", "G_", "G_", "G_", "G_", "G_", "G_", "G_", "G_", "G_", "G_", "W_", "A_"],
			["V_", "W_", "G_", "G_", "G_", "G_", "G_", "G_", "G_", "G_", "G_", "G_", "G_", "G_", "G_", "G_", "DE", "A_"],
			["V_", "W_", "G_", "G_", "G_", "G_", "G_", "G_", "G_", "G_", "G_", "G_", "G_", "G_", "G_", "G_", "W_", "A_"],
			["V_", "W_", "W_", "W_", "W_", "W_", "W_", "W_", "W_", "W_", "W_", "W_", "W_", "W_", "W_", "W_", "W_", "V_"],
			["V_", "V_", "V_", "V_", "V_", "V_", "V_", "V_", "V_", "V_", "V_", "V_", "V_", "V_", "V_", "V_", "V_", "V_"]
		],
		[
			["V_", "V_", "V_", "V_", "V_", "V_", "V_", "V_", "V_", "V_", "V_", "V_", "V_", "V_", "V_", "V_", "V_", "V_"],
			["V_", "W_", "W_", "W_", "W_", "W_", "W_", "W_", "W_", "W_", "W_", "W_", "W_", "W_", "W_", "W_", "W_", "V_"],
			["V_", "W_", "G_", "G_", "G_", "G_", "G_", "G_", "G_", "G_", "G_", "G_", "G_", "G_", "G_", "G_", "W_", "A_"],
			["V_", "W_", "G_", "G_", "G_", "G_", "G_", "G_", "G_", "G_", "G_", "G_", "G_", "G_", "G_", "G_", "DE", "A_"],
			["V_", "W_", "G_", "G_", "G_", "G_", "G_", "G_", "G_", "G_", "G_", "G_", "G_", "G_", "G_", "G_", "W_", "A_"],
			["V_", "W_", "G_", "G_", "G_", "G_", "G_", "G_", "G_", "G_", "G_", "G_", "G_", "W_", "W_", "W_", "W_", "V_"],
			["V_", "W_", "G_", "G_", "G_", "G_", "G_", "G_", "G_", "G_", "G_", "G_", "G_", "W_", "V_", "V_", "V_", "V_"],
			["V_", "W_", "G_", "I_", "G_", "I_", "G_", "I_", "G_", "I_", "G_", "I_", "G_", "W_", "V_", "V_", "V_", "V_"],
			["V_", "W_", "G_", "G_", "G_", "G_", "G_", "G_", "G_", "G_", "G_", "G_", "G_", "W_", "V_", "V_", "V_", "V_"],
			["V_", "W_", "W_", "W_", "W_", "W_", "W_", "W_", "W_", "W_", "W_", "W_", "W_", "W_", "V_", "V_", "V_", "V_"],
			["V_", "V_", "V_", "V_", "V_", "V_", "V_", "V_", "V_", "V_", "V_", "V_", "V_", "V_", "V_", "V_", "V_", "V_"]
		]
	]
}
