{
	"rooms": [
		[
			["V_", "V_", "V_", "A_", "A_", "A_", "V_", "V_", "V_"],
			["V_", "W_", "W_", "W_", "DN", "W_", "W_", "W_", "V_"],
			["V_", "W_", "G_", "G_", "G_", "G_", "G_", "W_", "V_"],
			["V_", "W_", "G_", "G_", "C_", "G_", "G_", "W_", "V_"],
			["V_", "W_", "G_", "G_", "G_", "G_", "G_", "W_", "V_"],
			["V_", "W_", "W_", "W_", "W_", "W_", "W_", "W_", "V_"],
			["V_", "V_", "V_", "V_", "V_", "V_", "V_", "V_", "V_"]
		],
		[
			["A_", "A_", "A_", "A_", "V_", "A_", "A_", "A_", "V_", "A_", "A_", "A_", "A_"],
			["A_", "A_", "A_", "V_", "V_", "W_", "DN", "W_", "V_", "V_", "A_", "A_", "A_"],
			["A_", "A_", "V_", "V_", "W_", "W_", "G_", "W_", "W_", "V_", "V_", "A_", "A_"],
			["A_", "V_", "V_", "W_", "W_", "G_", "G_", "G_", "W_", "W_", "V_", "V_", "A_"],
			["V_", "V_", "W_", "W_", "G_", "G_", "G_", "G_", "G_", "W_", "W_", "V_", "V_"],
			["V_", "W_", "W_", "G_", "G_", "G_", "G_", "G_", "G_", "G_", "W_", "W_", "V_"],
			["V_", "W_", "G_", "G_", "G_", "G_", "C_", "G_", "G_", "G_", "G_", "W_", "V_"],
			["V_", "W_", "W_", "G_", "G_", "G_", "G_", "G_", "G_", "G_", "W_", "W_", "V_"],
			["V_", "V_", "W_", "W_", "G_", "G_", "G_", "G_", "G_", "W_", "W_", "V_", "V_"],
			["A_", "V_", "V_", "W_", "W_", "G_", "G_", "G_", "W_", "W_", "V_", "V_", "A_"],
			["A_", "A_", "V_", "V_", "W_", "W_", "G_", "W_", "W_", "V_", "V_", "A_", "A_"],
			["A_", "A_", "A_", "V_", "V_", "W_", "W_", "W_", "V_", "V_", "A_", "A_", "A_"],
			["A_", "A_", "A_", "A_", "V_", "V_", "V_", "V_", "V_", "A_", "A_", "A_", "A_"]
		]
	]
}
